Tank Battle Demo
MaxSteps = 50
NumShells = 10
Rows = 6
Cols = 13
#########@@@#
########@ 1@#
#@@@ ### @@@#
#@2@     ####
#@@@   # @@@#
#############
