Random Board
MaxSteps =22
NumShells =31
Rows = 6
Cols =  10
#2 @  @#  
  2#@   @2
22# #### #
@ 1 1 ##@#
1@#@ # 22 
 2 2#   12
